Tran Date,Category,Particulars,,Value Date,Tran Type,Cheque Details,Withdrawal,Deposit,Balance Amount
27-09-2024,General Expenses,Peanuts,,27-09-2024,TFR ,,40,," ? 6,43,620 "
27-09-2024,Job Expenses,Bus From Hubli,,27-09-2024,TFR ,," ? 2,000 ",," ? 6,43,660 "
27-09-2024,Protein,Paneer,,27-09-2024,TFR ,, ? 100 ,," ? 6,45,660 "
26-09-2024,Baby Expenses,Uber from Her Place,,26-09-2024,TFR ,, ? 96 ,," ? 6,45,760 "
26-09-2024,Job Expenses,Flight,,26-09-2024,TFR ,," ? 4,934 ",," ? 6,45,856 "
26-09-2024,Job Expenses,Flight,,26-09-2024,TFR ,," ? 4,934 ",," ? 6,50,790 "
25-09-2024,Protein,Paneer,,25-09-2024,TFR ,, ? 100 ,," ? 6,55,724 "
25-09-2024,General Expenses,Bank Alert Charges,,25-09-2024,TFR ,, ? 6 ,," ? 6,55,824 "
24-09-2024,Job Expenses,Uber from Bangalore Airport,,24-09-2024,TFR ,, ? 947 ,," ? 6,55,829 "
24-09-2024,Job Expenses,Uber to Chennai Airport,,24-09-2024,TFR ,, ? 628 ,," ? 6,56,776 "
24-09-2024,Job Expenses,Uber to Client Place,,24-09-2024,TFR ,, ? 150 ,," ? 6,57,404 "
24-09-2024,Job Expenses,Hotel Expenses ,,24-09-2024,TFR ,," ? 12,320 ",," ? 6,57,554 "
23-09-2024,Job Expenses,Uber to Hotel,,23-09-2024,TFR ,, ? 150 ,," ? 6,69,874 "
23-09-2024,Income,Reimbursement from Job,,23-09-2024,TFR ,,," ? 16,541 "," ? 6,70,024 "
23-09-2024,Job Expenses,Uber from Hotel to Client Place,,23-09-2024,TFR ,, ? 180 ,," ? 6,53,483 "
23-09-2024,Job Expenses,Breakfast,,23-09-2024,TFR ,," ? 1,888 ",," ? 6,53,663 "
23-09-2024,Job Expenses,Uber from Chennai Airport,,23-09-2024,TFR ,, ? 444 ,," ? 6,55,551 "
23-09-2024,Job Expenses,Uber to Bangalore Airport,,23-09-2024,TFR ,," ? 1,180 ",," ? 6,55,995 "
22-09-2024,Baby Expenses,Uber from Her Place,,22-09-2024,TFR ,, ? 180 ,," ? 6,57,175 "
22-09-2024,Baby Expenses,Uber to Her Place,,22-09-2024,TFR ,, ? 130 ,," ? 6,57,355 "
22-09-2024,Baby Expenses,Lunch,,22-09-2024,TFR ,, ? 809 ,," ? 6,57,485 "
22-09-2024,General Expenses,Tea,,22-09-2024,TFR ,, ? 30 ,," ? 6,58,294 "
21-09-2024,General Income,Paid for Sweet Potato,,21-09-2024,TFR ,,, ? 30 ," ? 6,58,324 "
21-09-2024,Protein,Paneer | Sweet Potato | Yogurt,,21-09-2024,TFR ,, ? 195 ,," ? 6,58,294 "
21-09-2024,Protein,Protein Powder,,21-09-2024,TFR ,," ? 1,080 ",," ? 6,58,489 "
21-09-2024,General Expenses,Fruits,,21-09-2024,TFR ,, ? 70 ,," ? 6,59,569 "
21-09-2024,Driving Licenses Expenses,Paid for Learner's Exam,,21-09-2024,TFR ,, ? 110 ,," ? 6,59,639 "
20-09-2024,Baby Expenses,Juice for Baby,,20-09-2024,TFR ,, ? 90 ,," ? 6,59,749 "
19-09-2024,Protein,Paneer,,19-09-2024,TFR ,, ? 100 ,," ? 6,59,839 "
18-09-2024,Job Expenses,Uber from Bangalore Airport,,18-09-2024,TFR ,," ? 1,042 ",," ? 6,59,939 "
18-09-2024,Job Expenses,Uber to Chennai Airport,,18-09-2024,TFR ,, ? 869 ,," ? 6,60,981 "
18-09-2024,Job Expenses,Uber to Client Place,,18-09-2024,TFR ,, ? 68 ,," ? 6,61,850 "
17-09-2024,Job Expenses,Uber to Client Place,,17-09-2024,TFR ,, ? 210 ,," ? 6,61,918 "
17-09-2024,Job Expenses,Uber to Client Place,,17-09-2024,TFR ,, ? 575 ,," ? 6,62,128 "
17-09-2024,Job Expenses,Uber to Bangalore Airport,,17-09-2024,TFR ,," ? 1,120 ",," ? 6,62,703 "
16-09-2024,General Expenses,Bubble Gum,,16-09-2024,TFR ,, ? 5 ,," ? 6,63,823 "
16-09-2024,Protein,Paneer,,16-09-2024,TFR ,, ? 135 ,," ? 6,63,828 "
16-09-2024,General Expenses,Tea,,16-09-2024,TFR ,, ? 30 ,," ? 6,63,963 "
15-09-2024,General Expenses,Phone Recharge,,15-09-2024,TFR ,, ? 211 ,," ? 6,63,993 "
13-09-2024,Driving Licenses Expenses,Paid for Learner's Exam,,13-09-2024,TFR ,, ? 360 ,," ? 6,64,204 "
13-09-2024,Home Coming Expenses,Clothes for Onam,,13-09-2024,TFR ,,569,," ? 6,64,564 "
13-09-2024,Home Coming Expenses,Clothes for Onam,,13-09-2024,TFR ,," ? 3,544 ",," ? 6,65,133 "
13-09-2024,Home Coming Expenses,Tailor,,13-09-2024,TFR ,, ? 430 ,," ? 6,68,677 "
11-09-2024,Home Coming Expenses,Food,,11-09-2024,TFR ,, ? 165 ,," ? 6,69,107 "
11-09-2024,Home Coming Expenses,Food,,11-09-2024,TFR ,, ? 60 ,," ? 6,69,272 "
11-09-2024,Home Coming Expenses,Metro Ticket,,11-09-2024,TFR ,, ? 33 ,," ? 6,69,332 "
11-09-2024,Protein,Paneer,,11-09-2024,TFR ,, ? 100 ,," ? 6,69,365 "
10-09-2024,Rent,Rent for September,,10-09-2024,TFR ,," ? 8,000 ",," ? 6,69,465 "
10-09-2024,,,,10-09-2024,TFR ,, ? 162 ,," ? 6,77,465 "
10-09-2024,Protein,Paneer,,10-09-2024,TFR ,, ? 100 ,," ? 6,77,627 "
09-09-2024,Protein,Paneer,,09-09-2024,TFR ,, ? 100 ,," ? 6,77,727 "
09-09-2024,Job Expenses,Uber from Office,,09-09-2024,TFR ,, ? 125 ,," ? 6,77,827 "
08-09-2024,Home Coming Expenses,From Home,,08-09-2024,TFR ,, ? 905 ,," ? 6,77,952 "
08-09-2024,Baby Expenses,Lunch,,08-09-2024,TFR ,, ? 385 ,," ? 6,78,857 "
08-09-2024,Protein,Paneer,,08-09-2024,TFR ,, ? 100 ,," ? 6,79,242 "
08-09-2024,General Expenses,Tea,,08-09-2024,TFR ,, ? 30 ,," ? 6,79,342 "
07-09-2024,Protein,Paneer,,07-09-2024,TFR ,, ? 127 ,," ? 6,79,372 "
07-09-2024,General Expenses,Lunch Paid to Amar,,07-09-2024,TFR ,, ? 290 ,," ? 6,79,499 "
07-09-2024,Income,Salary from Job,,07-09-2024,TFR ,,," ? 57,063 "," ? 6,79,789 "
04-09-2024,General Income,Uber Refund,,04-09-2024,TFR ,,, ? 1 ," ? 6,22,726 "
03-09-2024,Job Expenses,Cab from Bangalore Airport,,03-09-2024,TFR ,," ? 1,000 ",," ? 6,22,725 "
03-09-2024,Job Expenses,Cab to Chennai Airport,,03-09-2024,TFR ,, ? 633 ,," ? 6,23,725 "
03-09-2024,Job Expenses,Hotel to Client Place,,03-09-2024,TFR ,, ? 67 ,," ? 6,24,358 "
02-09-2024,Job Expenses,Dinner,,02-09-2024,TFR ,," ? 1,859 ",," ? 6,24,425 "
02-09-2024,Job Expenses,Hotel to Client Place,,02-09-2024,TFR ,, ? 66 ,," ? 6,26,284 "
02-09-2024,Job Expenses,Cab to Bangalore Airport,,02-09-2024,TFR ,, ? 980 ,," ? 6,26,350 "
02-09-2024,General Expenses,Uber Pullup,,02-09-2024,TFR ,, ? 1 ,," ? 6,27,330 "
01-09-2024,General Expenses,Metro Ticket,,01-09-2024,TFR ,, ? 10 ,," ? 6,27,331 "
01-09-2024,General Expenses,Fruits,,01-09-2024,TFR ,, ? 40 ,," ? 6,27,341 "
01-09-2024,General Expenses,Fruits,,01-09-2024,TFR ,, ? 75 ,," ? 6,27,381 "
01-09-2024,General Expenses,Breakfast,,01-09-2024,TFR ,, ? 70 ,," ? 6,27,456 "
31-08-2024,Baby Income,She Paid Her Lunch for some fucking reason like a retard,,31-08-2024,TFR ,,, ? 250 ," ? 6,27,526 "
30-08-2024,Job Expenses,Financials From Zauba,,30-08-2024,TFR ,," ? 2,944 ",," ? 6,27,276 "
30-08-2024,General Income,Rajasreena Paid,,30-08-2024,TFR ,,, ? 20 ," ? 6,30,220 "
30-08-2024,General Expenses,Fruits,,30-08-2024,TFR ,, ? 40 ,," ? 6,30,200 "
29-08-2024,Job Expenses,Flight,,29-08-2024,TFR ,," ? 5,041 ",," ? 6,30,240 "
29-08-2024,Job Expenses,Flight,,29-08-2024,TFR ,," ? 2,389 ",," ? 6,35,281 "
28-08-2024,General Expenses,Lays,,28-08-2024,TFR ,, ? 20 ,," ? 6,37,670 "
28-08-2024,General Expenses,Curd,,28-08-2024,TFR ,, ? 20 ,," ? 6,37,690 "
28-08-2024,General Expenses,Bank Alert Charges,,28-08-2024,TFR ,, ? 2 ,," ? 6,37,710 "
28-08-2024,General Expenses,UPIOUT/424151210173/Q161798090@ybl/Payment f/5812,,28-08-2024,TFR ,, ? 60 ,," ? 6,37,712 "
28-08-2024,Investment,LIC Dividend,,28-08-2024,TFR ,,, ? 90 ," ? 6,37,772 "
27-08-2024,General Expenses,Lays,,27-08-2024,TFR ,, ? 20 ,," ? 6,37,682 "
25-08-2024,Baby Expenses,Lunch,,25-08-2024,TFR ,, ? 419 ,," ? 6,37,702 "
25-08-2024,Baby Expenses,Water,,25-08-2024,TFR ,, ? 25 ,," ? 6,38,121 "
25-08-2024,Baby Expenses,Uber to Cubbon,,25-08-2024,TFR ,, ? 92 ,," ? 6,38,146 "
24-08-2024,General Expenses,Tea,,24-08-2024,TFR ,, ? 30 ,," ? 6,38,238 "
24-08-2024,General Expenses,Fruits,,24-08-2024,TFR ,, ? 40 ,," ? 6,38,268 "
24-08-2024,General Expenses,More Retail - Purchased Lotion,,24-08-2024,TFR ,, ? 394 ,," ? 6,38,308 "
24-08-2024,General Expenses,Tea,,24-08-2024,TFR ,, ? 30 ,," ? 6,38,701 "
24-08-2024,Investment,LIC Stock Put Out,,24-08-2024,TFR ,,," ? 15,953 "," ? 6,38,731 "
23-08-2024,Income,Reimbursement from Job,,23-08-2024,TFR ,,," ? 5,889 "," ? 6,22,778 "
23-08-2024,General Expenses,Phone Recharge,,23-08-2024,TFR ,, ? 211 ,," ? 6,16,889 "
22-08-2024,Job Expenses,Auto to Client Place,,22-08-2024,TFR ,, ? 454 ,," ? 6,17,100 "
22-08-2024,General Expenses,Medicine,,22-08-2024,TFR ,, ? 94 ,," ? 6,17,554 "
21-08-2024,General Expenses,Paid to Amar,,21-08-2024,TFR ,, ? 120 ,," ? 6,17,648 "
21-08-2024,General Expenses,Bread & Peanut Butter,,21-08-2024,TFR ,, ? 115 ,," ? 6,17,768 "
21-08-2024,General Expenses,Fruits,,21-08-2024,TFR ,, ? 120 ,," ? 6,17,883 "
18-08-2024,General Expenses,Uber from Office,,18-08-2024,TFR ,, ? 90 ,," ? 6,18,003 "
18-08-2024,General Expenses,Bubble Gum,,18-08-2024,TFR ,, ? 4 ,," ? 6,18,093 "
18-08-2024,General Expenses,Tea,,18-08-2024,TFR ,, ? 20 ,," ? 6,18,097 "
17-08-2024,Driving Licenses Expenses,Paid for Classes,,17-08-2024,TFR ,," ? 6,000 ",," ? 6,18,117 "
15-08-2024,General Expenses,Fruits,,15-08-2024,TFR ,, ? 40 ,," ? 6,24,117 "
15-08-2024,General Expenses,Tea,,15-08-2024,TFR ,, ? 26 ,," ? 6,24,157 "
13-08-2024,General Expenses,Phone Cover,,13-08-2024,TFR ,, ? 159 ,," ? 6,24,183 "
11-08-2024,General Expenses,Laptop Repair,,11-08-2024,TFR ,, ? 500 ,," ? 6,24,342 "
11-08-2024,General Expenses,Milk,,11-08-2024,TFR ,, ? 20 ,," ? 6,24,842 "
09-08-2024,General Expenses,Vicks,,09-08-2024,TFR ,, ? 5 ,," ? 6,24,862 "
08-08-2024,Rent,Rent for August,,08-08-2024,TFR ,," ? 8,000 ",," ? 6,24,867 "
08-08-2024,Income,Varun Paid Back,,08-08-2024,TFR ,,," ? 3,000 "," ? 6,32,867 "
08-08-2024,Income,Salary from Job,,08-08-2024,TFR ,,," ? 2,904 "," ? 6,29,867 "
07-08-2024,Income,Salary from Job,,07-08-2024,TFR ,,," ? 54,159 "," ? 6,26,963 "
05-08-2024,Gym,Paid Gym,,05-08-2024,TFR ,," ? 9,754 ",," ? 5,72,804 "
04-08-2024,General Expenses,UPIOUT/421765463921/ptmtra6671@paytm/NA/4722,,04-08-2024,TFR ,, ? 21 ,," ? 5,82,558 "
04-08-2024,General Expenses,UPIOUT/421745322593/paytmqr591vvb@paytm/Paym/5812,,04-08-2024,TFR ,, ? 70 ,," ? 5,82,579 "
04-08-2024,General Expenses,UPIOUT/421738323339/pngdsibus@oksbi/Payment /0000,,04-08-2024,TFR ,, ? 5 ,," ? 5,82,649 "
03-08-2024,Home Coming Expenses,Recharged Amma's Phone,,03-08-2024,TFR ,, ? 249 ,," ? 5,82,654 "
03-08-2024,Investment,LIC Pay Out,,03-08-2024,TFR ,,," ? 1,23,300 "," ? 5,82,903 "
01-08-2024,Home Coming Expenses,Repaired My Watches,,01-08-2024,TFR ,, ? 850 ,," ? 4,59,603 "
01-08-2024,Home Coming Expenses,Groceries for Home,,01-08-2024,TFR ,, ? 470 ,," ? 4,60,453 "
01-08-2024,General Expenses,Phone Recharge,,01-08-2024,TFR ,, ? 211 ,," ? 4,60,923 "
26-07-2024,Office Expense,Paid Varun,,26-07-2024,TFR ,," ? 3,000 ",," ? 4,61,134 "
24-07-2024,Job Expenses,Financials From Zauba,,24-07-2024,TFR ,," ? 5,888 ",," ? 4,64,134 "
22-07-2024,Income,Reimbursement from Job,,22-07-2024,TFR ,,," ? 5,379 "," ? 4,70,022 "
21-07-2024,General Expenses,UPIOUT/420381941692/paytmqr1htwnbl8iz@paytm//5411,,21-07-2024,TFR ,, ? 140 ,," ? 4,64,643 "
20-07-2024,Home Coming Expenses,Uber to Home,,20-07-2024,TFR ,, ? 150 ,," ? 4,64,783 "
19-07-2024,General Expenses,UPIOUT/420131185111/paytmqr2810050501011wryr/5411,,19-07-2024,TFR ,, ? 80 ,," ? 4,64,933 "
19-07-2024,General Expenses,UPIOUT/456763297273/ptmtra6671@paytm/NA/4722,,19-07-2024,TFR ,, ? 33 ,," ? 4,65,013 "
19-07-2024,General Expenses,CHRG/MOB ALERT/JUN24,,19-07-2024,TFR ,, ? 5 ,," ? 4,65,046 "
18-07-2024,General Expenses,UPIOUT/420052931234/more.61831618@hdfcbank/P/5411,,18-07-2024,TFR ,, ? 491 ,," ? 4,65,051 "
18-07-2024,General Expenses,UPIOUT/420059359272/paytmqr28100505010193kyk/7230,,18-07-2024,TFR ,, ? 120 ,," ? 4,65,543 "
18-07-2024,Office Expense,Paid for Intern's Lunch,,18-07-2024,TFR ,, ? 395 ,," ? 4,65,663 "
17-07-2024,Home Coming Expenses,Booked Bus for Hari,,17-07-2024,TFR ,, ? 820 ,," ? 4,66,058 "
17-07-2024,General Expenses,Tea,,17-07-2024,TFR ,, ? 20 ,," ? 4,66,878 "
16-07-2024,Home Coming Expenses,Bus to Home,,16-07-2024,TFR ,, ? 820 ,," ? 4,66,898 "
16-07-2024,Home Coming Expenses,Bus From Home,,16-07-2024,TFR ,, ? 700 ,," ? 4,67,718 "
16-07-2024,General Expenses,Fruits,,16-07-2024,TFR ,, ? 40 ,," ? 4,68,418 "
14-07-2024,General Income,Amar Paid,,14-07-2024,TFR ,,, ? 40 ," ? 4,68,458 "
14-07-2024,General Expenses,UPIOUT/419612608069/BHARATPE.90070730761@fbp/5814,,14-07-2024,TFR ,, ? 100 ,," ? 4,68,418 "
14-07-2024,General Expenses,UPIOUT/419697643928/Q899362555@ybl/Payment f/5411,,14-07-2024,TFR ,, ? 3 ,," ? 4,68,518 "
13-07-2024,General Expenses,UPIOUT/419508586034/Q899362555@ybl/Payment f/5411,,13-07-2024,TFR ,, ? 30 ,," ? 4,68,521 "
13-07-2024,General Expenses,Milk,,13-07-2024,TFR ,, ? 10 ,," ? 4,68,551 "
13-07-2024,General Expenses,UPIOUT/419574722395/paytmqr6eumhd0g38@paytm//5812,,13-07-2024,TFR ,, ? 30 ,," ? 4,68,561 "
12-07-2024,General Expenses,UPIOUT/419459642350/paytmqr2810050501011timh/5411,,12-07-2024,TFR ,, ? 52 ,," ? 4,68,591 "
11-07-2024,Rent,Rent for July,,11-07-2024,TFR ,," ? 8,000 ",," ? 4,68,643 "
11-07-2024,General Expenses,UPIOUT/419352018636/Q104666505@ybl/Payment f/5812,,11-07-2024,TFR ,, ? 10 ,," ? 4,76,643 "
11-07-2024,General Expenses,UPIOUT/419311805258/Q104666505@ybl/Payment f/5812,,11-07-2024,TFR ,, ? 40 ,," ? 4,76,653 "
11-07-2024,General Expenses,UPIOUT/419334179611/8970060931@axl/Payment f/0000,,11-07-2024,TFR ,, ? 428 ,," ? 4,76,693 "
11-07-2024,General Expenses,UPIOUT/419338493604/9538872937@axl/Payment f/0000,,11-07-2024,TFR ,, ? 425 ,," ? 4,77,121 "
10-07-2024,General Expenses,UPIOUT/419286426566/Q899362555@ybl/Payment f/5411,,10-07-2024,TFR ,, ? 20 ,," ? 4,77,546 "
09-07-2024,Office Expense,Wonderlaa With Boys,,09-07-2024,TFR ,," ? 2,103 ",," ? 4,77,566 "
08-07-2024,Income,Salary from Job,,08-07-2024,TFR ,,," ? 43,000 "," ? 4,79,669 "
06-07-2024,General Expenses,UPIOUT/418811005437/Q320921002@ybl/Payment f/5411,,06-07-2024,TFR ,, ? 130 ,," ? 4,36,669 "
06-07-2024,General Expenses,UPIOUT/418860853073/9740012013@ybl/Payment f/0000,,06-07-2024,TFR ,, ? 60 ,," ? 4,36,799 "
06-07-2024,General Expenses,UPIOUT/418886783304/9334780470paytm@ibl/Paym/0000,,06-07-2024,TFR ,, ? 87 ,," ? 4,36,859 "
04-07-2024,General Expenses,UPIOUT/418627481706/8197952520@ibl/Payment f/0000,,04-07-2024,TFR ,, ? 92 ,," ? 4,36,946 "
04-07-2024,Job Expenses,Financials From Zauba,,04-07-2024,TFR ,," ? 2,944 ",," ? 4,37,038 "
04-07-2024,Job Expenses,Financials From Zauba,,04-07-2024,TFR ,, ? 589 ,," ? 4,39,982 "
04-07-2024,General Expenses,UPIOUT/418681360561/fcbizdwz5op@freecharge/P/5411,,04-07-2024,TFR ,, ? 105 ,," ? 4,40,570 "
03-07-2024,General Expenses,UPIOUT/418505244076/6269667879@apl/Payment f/0000,,03-07-2024,TFR ,, ? 389 ,," ? 4,40,675 "
03-07-2024,General Expenses,UPIOUT/418530794707/8660065448@okbizaxis/Pay/5411,,03-07-2024,TFR ,, ? 425 ,," ? 4,41,064 "
03-07-2024,General Expenses,UPIOUT/418518024508/Q277214964@ybl/Payment f/5411,,03-07-2024,TFR ,, ? 15 ,," ? 4,41,489 "
02-07-2024,General Expenses,UPIOUT/418432440708/chethan88kumar@okhdfcban/0000,,02-07-2024,TFR ,, ? 86 ,," ? 4,41,504 "
01-07-2024,General Expenses,UPIOUT/418335957523/paytmqr1kgnwny7lu@paytm//5411,,01-07-2024,TFR ,, ? 40 ,," ? 4,41,590 "
30-06-2024,General Expenses,UPIOUT/418256499878/paytmqr1uq39pve6y@paytm//5812,,30-06-2024,TFR ,, ? 120 ,," ? 4,41,630 "
30-06-2024,General Expenses,UPIOUT/418211717167/Q243320380@ybl/Payment f/5814,,30-06-2024,TFR ,, ? 24 ,," ? 4,41,750 "
30-06-2024,General Expenses,UPIOUT/418285161874/q714981526@ybl/UPI/5411,,30-06-2024,TFR ,, ? 20 ,," ? 4,41,774 "
29-06-2024,General Expenses,UPIOUT/418157869683/paytmqrkwa340ukhb@paytm//5411,,29-06-2024,TFR ,, ? 40 ,," ? 4,41,794 "
29-06-2024,General Expenses,UPIOUT/418191349170/chandrapoorna83@ybl/Paym/0000,,29-06-2024,TFR ,, ? 110 ,," ? 4,41,834 "
29-06-2024,General Expenses,SBINT:29-03-2024 to 28-06-2024[13450100174640],,28-06-2024,TFR ,,," ? 2,853 "," ? 4,41,944 "
28-06-2024,General Expenses,UPIOUT/418093113847/7396630505@axl/Payment f/0000,,28-06-2024,TFR ,, ? 78 ,," ? 4,39,091 "
28-06-2024,General Expenses,Phone Recharge,,28-06-2024,TFR ,, ? 181 ,," ? 4,39,169 "
28-06-2024,,UPIOUT/418077544990/paytm-58493@paytm/Paymen/4215,,28-06-2024,TFR ,, ? 637 ,," ? 4,39,350 "
27-06-2024,,UPIOUT/417937177966/Q899362555@ybl/Payment f/5411,,27-06-2024,TFR ,, ? 20 ,," ? 4,39,988 "
26-06-2024,,UPIOUT/417816553562/q899362555@ybl/UPI/5411,,26-06-2024,TFR ,, ? 20 ,," ? 4,40,008 "
25-06-2024,Income,Reimbursement from Job,,25-06-2024,TFR ,,," ? 1,517 "," ? 4,40,028 "
24-06-2024,,UPI IN/454267164375/amarprabhu567@okicici/UP/0000,,24-06-2024,TFR ,,, ? 50 ," ? 4,38,511 "
24-06-2024,,UPIOUT/417601369648/paytmqrfnucjfisqu@paytm//5411,,24-06-2024,TFR ,, ? 40 ,," ? 4,38,461 "
23-06-2024,,UPIOUT/417597113860/Q459516968@ybl/Payment f/5814,,23-06-2024,TFR ,, ? 131 ,," ? 4,38,501 "
22-06-2024,,UPIOUT/417487780536/Q714981526@ybl/Payment f/5411,,22-06-2024,TFR ,, ? 20 ,," ? 4,38,632 "
21-06-2024,,UPIOUT/417318731770/paytmqryu4fllp961@paytm//5912,,21-06-2024,TFR ,, ? 30 ,," ? 4,38,652 "
21-06-2024,,CHRG/MOB ALERT/MAY24,,21-06-2024,TFR ,, ? 2 ,," ? 4,38,682 "
19-06-2024,,UPIOUT/417101583456/Q714981526@ybl/Payment f/5411,,19-06-2024,TFR ,, ? 70 ,," ? 4,38,684 "
18-06-2024,,UPIOUT/417027681950/Q827914771@ybl/Payment f/5814,,18-06-2024,TFR ,, ? 120 ,," ? 4,38,754 "
18-06-2024,,UPIOUT/417031372610/paytmqr1dz831pitd@paytm//5411,,18-06-2024,TFR ,, ? 40 ,," ? 4,38,874 "
15-06-2024,,UPIOUT/416785304776/Q714981526@ybl/Payment f/5411,,15-06-2024,TFR ,, ? 20 ,," ? 4,38,914 "
15-06-2024,,UPIOUT/416780625038/Q714981526@ybl/Payment f/5411,,15-06-2024,TFR ,, ? 40 ,," ? 4,38,934 "
14-06-2024,,UPIOUT/416628699515/Q378936703@ybl/Payment f/5812,,14-06-2024,TFR ,, ? 40 ,," ? 4,38,974 "
14-06-2024,,UPIOUT/416675760087/paytmqrinwotvacvz@paytm//5812,,14-06-2024,TFR ,, ? 30 ,," ? 4,39,014 "
13-06-2024,,UPIOUT/416544086120/paytmqr1kgnwny7lu@paytm//5411,,13-06-2024,TFR ,, ? 40 ,," ? 4,39,044 "
12-06-2024,,UPIOUT/416498528371/Q104666505@ybl/Payment f/5812,,12-06-2024,TFR ,, ? 40 ,," ? 4,39,084 "
11-06-2024,,UPI IN/452908970788/amarprabhu567@okicici/UP/0000,,11-06-2024,TFR ,,, ? 98 ," ? 4,39,124 "
11-06-2024,,UPIOUT/416331082739/Q166150343@ybl/Payment f/5812,,11-06-2024,TFR ,, ? 240 ,," ? 4,39,026 "
11-06-2024,,UPIOUT/416358886994/Q524024276@ybl/Payment f/5411,,11-06-2024,TFR ,, ? 100 ,," ? 4,39,266 "
11-06-2024,,UPIOUT/416371494474/Q00977372@ybl/Payment fr/0000,,11-06-2024,TFR ,, ? 425 ,," ? 4,39,366 "
11-06-2024,,UPIOUT/416387193102/8197733260@axl/Payment f/0000,,11-06-2024,TFR ,, ? 425 ,," ? 4,39,791 "
11-06-2024,General Expenses,Phone Recharge,,11-06-2024,TFR ,, ? 181 ,," ? 4,40,216 "
11-06-2024,,UPIOUT/416345046807/Q899362555@ybl/Payment f/5411,,11-06-2024,TFR ,, ? 20 ,," ? 4,40,397 "
10-06-2024,Rent,Rent for June,,10-06-2024,TFR ,," ? 8,000 ",," ? 4,40,417 "
09-06-2024,,UPIOUT/416134372070/innovdmartka@icici/Payme/5411,,09-06-2024,TFR ,, ? 635 ,," ? 4,48,417 "
09-06-2024,,UPIOUT/416117019829/Q243320380@ybl/Payment f/5814,,09-06-2024,TFR ,, ? 54 ,," ? 4,49,052 "
08-06-2024,,UPIOUT/416043742401/Q753654423@ybl/Payment f/5411,,08-06-2024,TFR ,, ? 30 ,," ? 4,49,106 "
07-06-2024,Income,Salary from Job,,07-06-2024,TFR ,,," ? 58,938 "," ? 4,49,136 "
07-06-2024,,UPIOUT/415969006460/Q942129380@ybl/Payment f/5814,,07-06-2024,TFR ,, ? 42 ,," ? 3,90,198 "
06-06-2024,,UPIOUT/415830825917/paytmqr1kgnwny7lu@paytm//5411,,06-06-2024,TFR ,, ? 40 ,," ? 3,90,240 "
05-06-2024,,UPI IN/452342453511/amarprabhu567@okicici/UP/0000,,05-06-2024,TFR ,,, ? 10 ," ? 3,90,280 "
05-06-2024,,UPIOUT/415789458294/Q338800875@ybl/Payment f/5411,,05-06-2024,TFR ,, ? 10 ,," ? 3,90,270 "
05-06-2024,,UPIOUT/415750369475/Q714981526@ybl/Payment f/5411,,05-06-2024,TFR ,, ? 40 ,," ? 3,90,280 "
04-06-2024,,UPIOUT/415682070310/JIOINAPPDIRECT1@axl/Paym/4814,,04-06-2024,TFR ,, ? 181 ,," ? 3,90,320 "
04-06-2024,,UPIOUT/415608008687/paytmqr1kgnwny7lu@paytm//5411,,04-06-2024,TFR ,, ? 40 ,," ? 3,90,501 "
03-06-2024,,UPI IN/415518253528/amarprabhu567@okhdfcbank/0000,,03-06-2024,TFR ,,, ? 125 ," ? 3,90,541 "
03-06-2024,,CASH:SELF,,03-06-2024,CASH ,,," ? 5,000 "," ? 3,90,416 "
03-06-2024,,UPIOUT/415591222621/Q462283406@ybl/Payment f/5812,,03-06-2024,TFR ,, ? 50 ,," ? 3,85,416 "
02-06-2024,,UPIOUT/415418552342/9342823271@okbizaxis/Pay/5812,,02-06-2024,TFR ,, ? 10 ,," ? 3,85,466 "
02-06-2024,,UPIOUT/415439381880/paytmqr1rz5jin6gn@paytm//5411,,02-06-2024,TFR ,, ? 40 ,," ? 3,85,476 "
02-06-2024,,UPIOUT/415407365973/paytmqr1rz5jin6gn@paytm//5411,,02-06-2024,TFR ,, ? 70 ,," ? 3,85,516 "
02-06-2024,,UPIOUT/415462564892/BHARATPE09904869236@yesb/5451,,02-06-2024,TFR ,, ? 140 ,," ? 3,85,586 "
02-06-2024,,UPIOUT/415462437769/Q243320380@ybl/Payment f/5814,,02-06-2024,TFR ,, ? 24 ,," ? 3,85,726 "
01-06-2024,,UPIOUT/415372252134/Q338800875@ybl/Payment f/5411,,01-06-2024,TFR ,, ? 23 ,," ? 3,85,750 "
28-05-2024,,UPIOUT/414976350477/paytmqr1kgnwny7lu@paytm//5411,,28-05-2024,TFR ,, ? 40 ,," ? 3,85,773 "
27-05-2024,,UPIOUT/414838250286/9663515817@axl/Payment f/0000,,27-05-2024,TFR ,, ? 80 ,," ? 3,85,813 "
27-05-2024,,CHRG/MOB ALERT/APR24,,27-05-2024,TFR ,, ? 3 ,," ? 3,85,893 "
26-05-2024,,UPIOUT/414751789235/Q899362555@ybl/Payment f/5411,,26-05-2024,TFR ,, ? 20 ,," ? 3,85,895 "
26-05-2024,,UPIOUT/414763137816/Q243320380@ybl/Payment f/5814,,26-05-2024,TFR ,, ? 24 ,," ? 3,85,915 "
25-05-2024,,UPIOUT/414638817616/paytmqr28100505010193kyk/7230,,25-05-2024,TFR ,, ? 120 ,," ? 3,85,939 "
25-05-2024,,UPIOUT/414649576215/Q714981526@ybl/Payment f/5411,,25-05-2024,TFR ,, ? 20 ,," ? 3,86,059 "
24-05-2024,,UPIOUT/414567008840/paytmqr1dz831pitd@paytm//5411,,24-05-2024,TFR ,, ? 40 ,," ? 3,86,079 "
22-05-2024,,UPIOUT/414396545261/keerthig3268@dlb/Payment/5411,,22-05-2024,TFR ,, ? 78 ,," ? 3,86,119 "
22-05-2024,Income,Reimbursement from Job,,22-05-2024,TFR ,,," ? 6,803 "," ? 3,86,197 "
21-05-2024,Gym,Paid Gym,,21-05-2024,TFR ,," ? 4,000 ",," ? 3,79,394 "
21-05-2024,,UPIOUT/414229077017/paytmqr1kgnwny7lu@paytm//5411,,21-05-2024,TFR ,, ? 40 ,," ? 3,83,394 "
20-05-2024,,TO ECM/414111407006/NSDL Database Manageme\NSDL Da,,20-05-2024,TFR ,," ? 1,536 ",," ? 3,83,434 "
19-05-2024,,UPIOUT/414089713775/Q899362555@ybl/Payment f/5411,,19-05-2024,TFR ,, ? 20 ,," ? 3,84,970 "
19-05-2024,,UPIOUT/414085824650/JIOINAPPDIRECT@ybl/Payme/4814,,19-05-2024,TFR ,, ? 482 ,," ? 3,84,990 "
19-05-2024,,UPIOUT/414093658098/Q243320380@ybl/Payment f/5814,,19-05-2024,TFR ,, ? 30 ,," ? 3,85,472 "
17-05-2024,,UPIOUT/413831364354/more.61831619@hdfcbank/P/5411,,17-05-2024,TFR ,, ? 504 ,," ? 3,85,502 "
17-05-2024,Job Expenses,Financials From Zauba,,17-05-2024,TFR ,, ? 589 ,," ? 3,86,006 "
17-05-2024,,UPIOUT/413812827855/paytmqr1v74fdutb6@paytm//5812,,17-05-2024,TFR ,, ? 20 ,," ? 3,86,595 "
16-05-2024,,UPIOUT/413791930176/Q109924309@ybl/Payment f/5411,,16-05-2024,TFR ,, ? 40 ,," ? 3,86,615 "
16-05-2024,,UPIOUT/413731926493/paytmqr1kgnwny7lu@paytm//5411,,16-05-2024,TFR ,, ? 40 ,," ? 3,86,655 "
14-05-2024,,UPIOUT/413590101586/paytmqr1kgnwny7lu@paytm//5411,,14-05-2024,TFR ,, ? 40 ,," ? 3,86,695 "
12-05-2024,,UPIOUT/413342543397/9847862259@ybl/Payment f/0000,,12-05-2024,TFR ,, ? 117 ,," ? 3,86,735 "
12-05-2024,,UPIOUT/413392516713/Q243320380@ybl/Payment f/5814,,12-05-2024,TFR ,, ? 30 ,," ? 3,86,852 "
11-05-2024,,UPIOUT/413282127776/Q002908155@ybl/Payment f/5411,,11-05-2024,TFR ,, ? 44 ,," ? 3,86,882 "
11-05-2024,General Expenses,Phone Recharge,,11-05-2024,TFR ,, ? 181 ,," ? 3,86,926 "
10-05-2024,,UPIOUT/413185018629/BHARATPE90727052565@yesb/5411,,10-05-2024,TFR ,, ? 72 ,," ? 3,87,107 "
10-05-2024,,UPIOUT/413136864356/Q299473407@ybl/Payment f/5462,,10-05-2024,TFR ,, ? 580 ,," ? 3,87,179 "
10-05-2024,,UPIOUT/413193158628/sachinhs7788-1@okaxis/Pa/0000,,10-05-2024,TFR ,, ? 425 ,," ? 3,87,759 "
09-05-2024,Rent,Rent for May,,09-05-2024,TFR ,," ? 8,250 ",," ? 3,88,184 "
09-05-2024,,UPIOUT/413010475347/paytmqr1kgnwny7lu@paytm//5411,,09-05-2024,TFR ,, ? 40 ,," ? 3,96,434 "
08-05-2024,,UPIOUT/412934850367/Q277214964@ybl/Payment f/5411,,08-05-2024,TFR ,, ? 20 ,," ? 3,96,474 "
08-05-2024,Income,Salary from Job,,08-05-2024,TFR ,,," ? 9,938 "," ? 3,96,494 "
07-05-2024,Income,Salary from Job,,07-05-2024,TFR ,,," ? 38,800 "," ? 3,86,556 "
05-05-2024,,UPIOUT/412622586096/Q714981526@ybl/Payment f/5411,,05-05-2024,TFR ,, ? 20 ,," ? 3,47,756 "
05-05-2024,,UPIOUT/412678898011/EKART@ybl/Payment for FM/5812,,05-05-2024,TFR ,, ? 954 ,," ? 3,47,776 "
05-05-2024,,UPIOUT/412694775007/Q243320380@ybl/Payment f/5814,,05-05-2024,TFR ,, ? 27 ,," ? 3,48,730 "
04-05-2024,,UPIOUT/412520917042/Q218816384@ybl/Payment f/5814,,04-05-2024,TFR ,, ? 210 ,," ? 3,48,757 "
04-05-2024,,UPIOUT/412539000081/Q899362555@ybl/Payment f/5411,,04-05-2024,TFR ,, ? 20 ,," ? 3,48,967 "
04-05-2024,,UPIOUT/412534572593/lokeshka2@axl/Payment fr/0000,,04-05-2024,TFR ,, ? 338 ,," ? 3,48,987 "
04-05-2024,,UPIOUT/412503060709/ashwathgowda090909@ibl/P/0000,,04-05-2024,TFR ,, ? 425 ,," ? 3,49,325 "
02-05-2024,,CASH:P S RAJALAKSHMI,,02-05-2024,CASH ,,," ? 5,000 "," ? 3,49,750 "
01-05-2024,,UPIOUT/412207641513/Q899362555@ybl/Payment f/5411,,01-05-2024,TFR ,, ? 20 ,," ? 3,44,750 "
30-04-2024,,UPIOUT/412191283397/9671978637@ybl/Payment f/0000,,30-04-2024,TFR ,, ? 333 ,," ? 3,44,770 "
28-04-2024,,UPIOUT/411996722796/Q899362555@ybl/Payment f/5411,,28-04-2024,TFR ,, ? 20 ,," ? 3,45,103 "
27-04-2024,,UPIOUT/411940226692/Q486616613@ybl/Payment f/5814,,28-04-2024,TFR ,, ? 85 ,," ? 3,45,123 "
27-04-2024,,UPIOUT/411892739417/Q109924309@ybl/Payment f/5411,,27-04-2024,TFR ,, ? 40 ,," ? 3,45,208 "
27-04-2024,,UPIOUT/411824311711/Q243320380@ybl/Payment f/5814,,27-04-2024,TFR ,, ? 30 ,," ? 3,45,248 "
25-04-2024,General Expenses,Phone Recharge,,25-04-2024,TFR ,, ? 181 ,," ? 3,45,278 "
24-04-2024,,UPIOUT/411579008854/Q899362555@ybl/Payment f/5411,,24-04-2024,TFR ,, ? 20 ,," ? 3,45,459 "
24-04-2024,,UPIOUT/411558155509/paytmqr1v74fdutb6@paytm//5812,,24-04-2024,TFR ,, ? 20 ,," ? 3,45,479 "
24-04-2024,,CHRG/MOB ALERT/MAR24,,24-04-2024,TFR ,, ? 5 ,," ? 3,45,499 "
24-04-2024,Job Expenses,Financials From Zauba,,24-04-2024,TFR ,," ? 1,178 ",," ? 3,45,503 "
24-04-2024,,UPIOUT/411589783335/Q714981526@ybl/Payment f/5411,,24-04-2024,TFR ,, ? 100 ,," ? 3,46,681 "
22-04-2024,Income,Reimbursement from Job,,22-04-2024,TFR ,,," ? 5,196 "," ? 3,46,781 "
21-04-2024,,UPI IN/411245811134/amarprabhu567@okicici/UP/0000,,21-04-2024,TFR ,,, ? 50 ," ? 3,41,585 "
21-04-2024,,UPIOUT/411213592660/Q714981526@ybl/Payment f/5411,,21-04-2024,TFR ,, ? 54 ,," ? 3,41,535 "
21-04-2024,,UPIOUT/411231868635/Q109924309@ybl/Payment f/5411,,21-04-2024,TFR ,, ? 100 ,," ? 3,41,589 "
21-04-2024,,UPIOUT/411271335831/Q109924309@ybl/Payment f/5411,,21-04-2024,TFR ,, ? 40 ,," ? 3,41,689 "
21-04-2024,,UPIOUT/411226507317/paytmqr6eumhd0g38@paytm//5812,,21-04-2024,TFR ,, ? 24 ,," ? 3,41,729 "
19-04-2024,,UPIOUT/411076443489/AMZN0026785247@apl/Payme/0000,,19-04-2024,TFR ,, ? 425 ,," ? 3,41,753 "
19-04-2024,,UPIOUT/411092585911/AMZN0026739113@apl/Payme/0000,,19-04-2024,TFR ,, ? 425 ,," ? 3,42,178 "
17-04-2024,General Expenses,Phone Recharge,,17-04-2024,TFR ,, ? 181 ,," ? 3,42,603 "
16-04-2024,Job Expenses,Financials From Zauba,,16-04-2024,TFR ,," ? 2,944 ",," ? 3,42,784 "
15-04-2024,,UPIOUT/410663739063/paytmqref1xbr8ywy@paytm//5812,,15-04-2024,TFR ,, ? 20 ,," ? 3,45,728 "
12-04-2024,,UPI IN/410315674948/hariharaiyer20@okicici/U/0000,,12-04-2024,TFR ,,," ? 9,000 "," ? 3,45,748 "
10-04-2024,Family Income,Money From Amma For Fruits,,10-04-2024,TFR ,, ? 589 ,," ? 3,36,748 "
07-04-2024,Income,Salary from Job,,07-04-2024,TFR ,,," ? 54,800 "," ? 3,37,337 "
05-04-2024,,UPIOUT/409665366546/Q751801445@ybl/Payment f/5814,,05-04-2024,TFR ,, ? 135 ,," ? 2,82,537 "
05-04-2024,,UPIOUT/409665366240/paytm-8736701@paytm/Oid2/4722,,05-04-2024,TFR ,, ? 33 ,," ? 2,82,672 "
05-04-2024,,UPIOUT/409691433018/9671978637@ybl/Payment f/0000,,05-04-2024,TFR ,, ? 348 ,," ? 2,82,705 "
04-04-2024,Rent,Rent for April,,04-04-2024,TFR ,," ? 8,000 ",," ? 2,83,053 "
04-04-2024,,UPIOUT/409522781482/keerthig3268@dlb/Payment/5411,,04-04-2024,TFR ,, ? 50 ,," ? 2,91,053 "
04-04-2024,Job Expenses,Financials From Zauba,,04-04-2024,TFR ,," ? 3,533 ",," ? 2,91,103 "
03-04-2024,Family Income,Money From Amma For Fruits,,03-04-2024,CASH ,,," ? 5,000 "," ? 2,94,636 "
02-04-2024,,UPIOUT/409392895591/9671978637@ybl/Payment f/0000,,02-04-2024,TFR ,," ? 1,000 ",," ? 2,89,636 "
